2nd Grade - Scheduled Explosions
Apifera - Keep the Outside Open
A Place To Bury Strangers - Synthesizer
Omar Apollo - God Said No
ARI TSUGI - Simultaneity (同時性)
Astral Bakers - The Whole Story
Bacao Rhythm & Steel Band - BRSB
BADBADNOTGOOD - Mid Spiral: Chaos
BALTVS - Harvest
beabadoobee - This Is How Tomorrow Moves
Beak> - >>>>
Benny the Butcher - Everybody Can't GoBenny the Butcher - Everybody Can't Go
Bibi Club - Feu de garde
The Black Keys - Ohio Players
Blitzen Trapper - 100’s of 1000’s, Millions of Billions
Blockhead - Luminous Rubble
Jake Blount & Mali Obomsawin - symbiont
Leon Bridges - Leon
Brijean - Macro
Caius - Strange Motions
Caoilfhionn Rose - Constellation
Caribou - Honey
Chicano Batman - Notebook Fantasy
Chinese American Bear - Wah!!!
Chong the Nomad - DO WE MAKE OF THIS
Chromeo - Adult Contemporary
Cigarettes After Sex - X's
Cimafunk - Pa’ Tu Cuerpa
Cosmic Analog Ensemble - Les Grandes Vacances (Bonus Version)
The Cure - Songs Of A Lost World
Yussef Dayes - Live From Malibu
Delicate Steve - Delicate Steve Sings
Discovery Zone - Quantum Web
Dr. Dog - Dr. Dog
Matt Duncan - I will Write Your Song
elbow - AUDIO VERTIGO
Father John Misty - Mahashmashana
Flamingo Pier - Supro EP
Floating Points - Cascade
Flying Lotus - Spirit Box EP
Font - Strange Burden
Four Tet - Three
Childish Gambino - Bando Stone & the New World
Mk.gee - Two Star & The Dream Police
Ghost Funk Orchesra - A Trip To The Moon
Goat - Goat
Goth Babe - LOLA
Habibi - Dreamachine
Hataałii - Waiting For A Sign
Maya Hawke - Chaos Angel
kiko hayashi - lost
The Headhunters - The Stunt Man
Hermanos Gutiérrez - Sonido Cósmico
Holiday Ghosts - Coat of Arms
Honeyglaze - Real Deal
Brittany Howard - What Now
Humdrum - Every Heaven
Ibibio Sound Machine - Pull the Rope
inuha - 陽のかけら / Hi No Kakera EP
Iron & Wine - Light Verse
Itasca - Imitation of War
Jamie xx - In Waves
Japandroids - Fate & Alcohol
José Junior - Spanish Leather
Kairos Creature Club - Kairos Creature Club
Karate Boogaloo - Hold Your Horses
Kasbo - The Learning of Urgency
Khruangbin - A LA SALA
Kiasmos - II
King GIzzard & the Lizard Wizard - Flight B741
Klaus Johann Grobe - lo Tu il Loro
Kokoroko - Get the Message 
Mo Kolours - Original Flow
Lime Garden - One More Thing
L’Impératrice - Pulsar
Local Natives - But I'll Wait For You
MIldlife - Chorus
MGMT - Loss of Life
Mount Kimbie - The Sunset Violent
Helado Negro - Phasor
Nada Surf - Moon MIrror
Willie Nelson - Last Leaf on the Tree
Nice Biscuit - SOS
Omni - Souvenir
Pale Jay - Low End Love Song
Pixies - The Night the Zombies Came
Jordan Rakei - The Loop
Maggie Rogers - Don't Forget Me
SAULT - Acts of Faith
Shigeto - Cherry Blossom Baby
STRFKR - Parallel Realms
Toro Y Moi - Hole Erth
Tycho - Infinite Health
Vampire Weekend - Only God Was Above Us
Washed Out - Notes From a Quiet Life
Kamasi Washington - Fearless Movement
Remi Wolf - Big Ideas